//this config file was auto-generated by Excel2lua tool do not modify it!
ID,BehaviorType,BehaviorParam
10001,1,
10002,4,4;300001
10004,4,4;300001
10005,1,
10006,4,4;300001
10007,1,
10008,4,4;300001
10009,1,
10010,4,4;300001
10011,1,
10012,4,4;300001
10014,4,4;142102
10013,4,4;142102
10015,4,4;201001
10016,4,4;201001
10018,1,
